#########
#       #
#  ###  #
#       #
#########