########
#   #  #
# # #*o#
#    *o#
# # #*o#
#   #  #
#####@ #
    ####